8,8,8,8,8,8,8,8,8,8,8,8,8,8,8,8,8,8,8
8,1,1,1,1,6,1,0,1,1,1,0,1,1,1,1,1,1,8
8,1,0,0,0,0,1,0,1,0,0,0,0,0,0,0,0,1,8
8,1,1,5,1,1,1,1,1,1,1,0,1,1,1,1,1,1,8
8,0,0,0,0,1,0,0,0,0,1,0,1,0,0,0,0,0,8
8,1,1,1,7,1,0,1,0,1,1,0,1,1,1,1,1,1,8
8,1,0,1,0,1,0,1,0,1,0,0,0,0,0,0,0,1,8
8,1,0,1,0,1,0,1,0,1,1,1,1,1,1,1,1,1,8
8,1,0,1,1,1,0,1,0,0,0,0,0,0,0,0,7,0,8
8,1,0,0,0,0,0,1,1,2,1,1,1,1,1,1,5,1,8
8,1,0,1,0,1,0,1,0,1,0,0,0,0,0,0,0,1,8
8,1,0,1,1,1,1,1,0,3,0,1,1,1,1,0,1,1,8
8,1,0,0,0,0,0,0,0,1,1,1,6,0,1,1,0,0,8
8,1,0,1,1,1,1,1,1,0,0,0,0,0,0,1,1,1,8
8,1,0,1,6,0,0,0,1,0,1,1,1,1,0,0,0,1,8
8,1,0,1,0,7,1,0,1,0,1,0,1,0,1,0,1,1,8
8,0,0,1,0,0,1,1,1,0,1,0,1,0,1,0,1,0,8
8,1,1,1,5,0,0,0,1,0,1,1,0,1,1,1,1,0,8
8,1,0,0,1,1,1,0,1,0,0,1,1,1,0,0,0,0,8
8,1,0,1,1,0,1,1,1,1,0,0,0,1,1,1,1,1,8
8,8,8,8,8,8,8,8,8,8,8,8,8,8,8,8,8,8,8